//MAP CONVERTED BY dmm2tgm.py THIS HEADER COMMENT PREVENTS RECONVERSION, DO NOT REMOVE
"a" = (
/turf/open/floor/rogue/blocks,
/area/rogue/outdoors/rtfield)
"b" = (
/obj/structure/stairs{
	dir = 1
	},
/turf/closed/wall/mineral/rogue/stone,
/area/rogue/outdoors/beach/south)
"f" = (
/obj/effect/spawner/lootdrop/roguetown/dungeon/materials,
/turf/open/floor/rogue/blocks,
/area/rogue/outdoors/rtfield)
"i" = (
/obj/effect/spawner/lootdrop/roguetown/dungeon/money,
/turf/open/floor/rogue/blocks,
/area/rogue/outdoors/rtfield)
"j" = (
/turf/closed/wall/mineral/rogue/stone,
/area/rogue/outdoors/beach/south)
"q" = (
/obj/effect/landmark/chest_or_mimic/loot_chest/locked,
/turf/open/floor/rogue/blocks,
/area/rogue/outdoors/rtfield)
"v" = (
/obj/effect/spawner/lootdrop/roguetown/dungeon/money,
/turf/open/transparent/openspace,
/area/rogue/outdoors/rtfield)
"w" = (
/turf/closed/wall/mineral/rogue/stone/blue_moss,
/area/rogue/outdoors/beach/south)
"x" = (
/obj/structure/rack/rogue,
/turf/open/floor/rogue/blocks,
/area/rogue/outdoors/beach/south)
"B" = (
/obj/structure/stairs{
	dir = 1
	},
/turf/open/transparent/openspace,
/area/rogue/outdoors/rtfield)
"C" = (
/obj/structure/rack/rogue,
/obj/effect/spawner/lootdrop/roguetown/dungeon/tools,
/turf/open/floor/rogue/blocks,
/area/rogue/outdoors/beach/south)
"E" = (
/turf/open/transparent/openspace,
/area/rogue/outdoors/rtfield)
"G" = (
/obj/structure/rack/rogue,
/obj/effect/spawner/lootdrop/roguetown/dungeon/weapons,
/turf/open/floor/rogue/blocks,
/area/rogue/outdoors/beach/south)
"K" = (
/turf/closed/wall/mineral/rogue/craftstone,
/area/rogue/outdoors/rtfield)
"M" = (
/obj/structure/stairs{
	dir = 1
	},
/turf/open/floor/rogue/blocks,
/area/rogue/outdoors/beach/south)
"N" = (
/mob/living/carbon/human/species/skeleton/npc/pirate,
/turf/open/floor/rogue/blocks,
/area/rogue/outdoors/rtfield)
"S" = (
/turf/open/floor/rogue/blocks,
/area/rogue/outdoors/beach/south)
"U" = (
/obj/structure/mineral_door/wood/violet{
	locked = 1
	},
/turf/open/floor/rogue/blocks,
/area/rogue/outdoors/beach/south)
"W" = (
/turf/closed/mineral/random/rogue,
/area/rogue/outdoors/beach/south)
"Y" = (
/mob/living/carbon/human/species/skeleton/npc/pirate,
/turf/open/floor/rogue/blocks,
/area/rogue/outdoors/beach/south)
"Z" = (
/turf/closed/wall/mineral/rogue/craftstone,
/area/rogue/outdoors/beach/south)

(1,1,1) = {"
W
w
w
Z
Z
Z
Z
Z
Z
"}
(2,1,1) = {"
w
w
j
j
b
M
S
S
w
"}
(3,1,1) = {"
w
w
j
j
b
M
S
S
w
"}
(4,1,1) = {"
w
C
S
S
x
S
S
S
Z
"}
(5,1,1) = {"
Z
S
Y
S
S
S
S
S
Z
"}
(6,1,1) = {"
Z
C
S
S
C
S
S
S
Z
"}
(7,1,1) = {"
w
S
S
S
S
S
Y
S
w
"}
(8,1,1) = {"
w
G
S
S
x
S
S
S
w
"}
(9,1,1) = {"
w
Z
U
Z
Z
w
w
Z
Z
"}

(1,1,2) = {"
K
K
a
a
K
K
K
K
a
"}
(2,1,2) = {"
K
a
a
a
B
E
E
E
a
"}
(3,1,2) = {"
K
a
a
a
B
E
E
E
a
"}
(4,1,2) = {"
K
N
a
E
E
E
E
E
K
"}
(5,1,2) = {"
K
a
a
E
E
E
E
a
K
"}
(6,1,2) = {"
K
a
E
E
E
E
E
a
a
"}
(7,1,2) = {"
K
a
E
E
E
E
N
a
a
"}
(8,1,2) = {"
K
a
a
a
a
a
a
a
K
"}
(9,1,2) = {"
K
K
K
a
a
a
K
K
K
"}

(1,1,3) = {"
v
E
E
a
K
K
a
a
E
"}
(2,1,3) = {"
K
E
E
a
a
a
a
E
E
"}
(3,1,3) = {"
K
E
E
E
E
E
E
E
E
"}
(4,1,3) = {"
K
a
E
E
E
E
E
E
E
"}
(5,1,3) = {"
K
a
E
E
E
E
E
E
E
"}
(6,1,3) = {"
K
a
a
E
E
E
E
E
E
"}
(7,1,3) = {"
K
a
a
E
E
E
E
E
E
"}
(8,1,3) = {"
K
a
a
E
E
E
a
a
K
"}
(9,1,3) = {"
K
K
a
E
E
a
a
a
K
"}

(1,1,4) = {"
E
E
E
E
f
a
E
E
E
"}
(2,1,4) = {"
E
E
E
E
E
E
E
E
E
"}
(3,1,4) = {"
E
E
E
E
E
E
E
E
E
"}
(4,1,4) = {"
K
E
E
E
E
E
E
E
E
"}
(5,1,4) = {"
K
E
E
E
E
E
E
E
E
"}
(6,1,4) = {"
K
E
E
E
E
E
E
E
E
"}
(7,1,4) = {"
a
E
E
E
E
E
E
E
E
"}
(8,1,4) = {"
a
E
E
E
E
E
E
E
a
"}
(9,1,4) = {"
i
a
E
E
E
E
E
q
a
"}
