//MAP CONVERTED BY dmm2tgm.py THIS HEADER COMMENT PREVENTS RECONVERSION, DO NOT REMOVE
"bI" = (
/mob/living/carbon/human/species/goblin/npc,
/turf/open/floor/rogue/dirt/road,
/area/rogue/under/tomb/cave)
"dI" = (
/obj/machinery/light/rogue/campfire/longlived,
/turf/open/floor/rogue/dirt,
/area/rogue/under/tomb/cave)
"ea" = (
/obj/structure/flora/roguegrass/water,
/turf/open/floor/rogue/dirt,
/area/rogue/under/tomb/cave)
"fn" = (
/obj/structure/ladder/earth,
/obj/structure/ladder/earth,
/turf/open/floor/rogue/dirt,
/area/rogue/under/tomb/cave)
"gL" = (
/mob/living/carbon/human/species/hobgoblin/npc,
/turf/open/floor/rogue/dirt,
/area/rogue/under/tomb/cave)
"mF" = (
/turf/closed/wall/mineral/rogue/tent{
	dir = 1
	},
/area/rogue/under/tomb/cave)
"mH" = (
/mob/living/carbon/human/species/hobgoblin/npc,
/turf/open/floor/rogue/naturalstone,
/area/rogue/under/tomb/cave)
"mJ" = (
/turf/closed/mineral/random/rogue/high,
/area/rogue/under/tomb/cave)
"na" = (
/obj/effect/spawner/lootdrop/general_loot_mid/x3,
/obj/structure/closet/crate/chest/wicker,
/turf/open/floor/rogue/dirt/road,
/area/rogue/under/tomb/cave)
"oe" = (
/obj/effect/dungeon_directional_helper/north,
/turf/open/floor/rogue/naturalstone,
/area/rogue/under/tomb/cave)
"ow" = (
/obj/structure/ladder/earth,
/turf/open/floor/rogue/dirt,
/area/rogue/under/tomb/cave)
"oI" = (
/obj/machinery/light/rogue/torchholder/l,
/turf/open/floor/rogue/naturalstone,
/area/rogue/under/tomb/cave)
"oS" = (
/obj/structure/chair/stool/rogue,
/turf/open/floor/rogue/dirt,
/area/rogue/under/tomb/cave)
"pp" = (
/obj/machinery/light/rogue/torchholder/c,
/turf/open/floor/rogue/dirt,
/area/rogue/under/tomb/cave)
"qX" = (
/obj/machinery/light/rogue/torchholder/l,
/turf/open/water/swamp,
/area/rogue/under/tomb/cave)
"rf" = (
/mob/living/carbon/human/species/goblin/npc,
/obj/structure/bed/rogue/shit,
/turf/open/floor/rogue/naturalstone,
/area/rogue/under/tomb/cave)
"sh" = (
/turf/open/floor/rogue/naturalstone,
/area/rogue/under/tomb/cave)
"tp" = (
/obj/effect/dungeon_directional_helper/west,
/turf/open/floor/rogue/naturalstone,
/area/rogue/under/tomb/cave)
"ve" = (
/obj/structure/flora/roguegrass/water,
/turf/open/water/swamp,
/area/rogue/under/tomb/cave)
"vx" = (
/obj/structure/bed/rogue/shit,
/turf/open/floor/rogue/dirt/road,
/area/rogue/under/tomb/cave)
"zi" = (
/obj/effect/dungeon_directional_helper/south,
/turf/open/floor/rogue/naturalstone,
/area/rogue/under/tomb/cave)
"Ax" = (
/obj/effect/spawner/lootdrop/general_loot_low/x3,
/obj/structure/closet/crate/chest/wicker,
/turf/open/floor/rogue/dirt/road,
/area/rogue/under/tomb/cave)
"BQ" = (
/obj/machinery/light/rogue/torchholder/l,
/turf/open/floor/rogue/dirt,
/area/rogue/under/tomb/cave)
"Cu" = (
/obj/structure/roguetent,
/turf/open/floor/rogue/dirt,
/area/rogue/under/tomb/cave)
"Es" = (
/obj/machinery/light/rogue/torchholder/r,
/turf/open/floor/rogue/naturalstone,
/area/rogue/under/tomb/cave)
"Hn" = (
/turf/closed/wall/mineral/rogue/tent,
/area/rogue/under/tomb/cave)
"Ip" = (
/turf/closed/wall/mineral/rogue/wood,
/area/rogue/under/tomb/cave)
"Iu" = (
/turf/closed/mineral/rogue/bedrock,
/area/rogue/under/tomb/cave)
"Jf" = (
/obj/structure/roguetent,
/turf/open/floor/rogue/dirt/road,
/area/rogue/under/tomb/cave)
"JD" = (
/obj/effect/dungeon_directional_helper/east,
/turf/open/floor/rogue/naturalstone,
/area/rogue/under/tomb/cave)
"JE" = (
/obj/structure/roguetent,
/turf/open/floor/rogue/naturalstone,
/area/rogue/under/tomb/cave)
"LG" = (
/mob/living/carbon/human/species/hobgoblin/npc,
/turf/open/floor/rogue/dirt/road,
/area/rogue/under/tomb/cave)
"Nf" = (
/turf/open/water/swamp,
/area/rogue/under/tomb/cave)
"Ns" = (
/mob/living/carbon/human/species/goblin/npc,
/turf/open/floor/rogue/dirt,
/area/rogue/under/tomb/cave)
"OG" = (
/obj/item/reagent_containers/food/snacks/rogue/meat/sausage{
	pixel_x = 6;
	pixel_y = 4
	},
/obj/item/grown/log/tree/stake,
/turf/open/floor/rogue/dirt,
/area/rogue/under/tomb/cave)
"Pg" = (
/turf/closed/wall/mineral/rogue/tent{
	dir = 8
	},
/area/rogue/under/tomb/cave)
"PN" = (
/turf/open/floor/rogue/dirt,
/area/rogue/under/tomb/cave)
"Qu" = (
/mob/living/carbon/human/species/goblin/npc,
/turf/open/floor/rogue/naturalstone,
/area/rogue/under/tomb/cave)
"Ri" = (
/turf/closed/wall/mineral/rogue/tent{
	dir = 4
	},
/area/rogue/under/tomb/cave)
"RG" = (
/mob/living/carbon/human/species/goblin/npc,
/obj/structure/bed/rogue/shit,
/turf/open/floor/rogue/dirt,
/area/rogue/under/tomb/cave)
"RT" = (
/obj/machinery/light/rogue/torchholder/c,
/turf/open/floor/rogue/naturalstone,
/area/rogue/under/tomb/cave)
"SP" = (
/turf/open/floor/rogue/dirt/road,
/area/rogue/under/tomb/cave)
"Yn" = (
/obj/machinery/light/rogue/torchholder/r,
/turf/open/floor/rogue/dirt,
/area/rogue/under/tomb/cave)

(1,1,1) = {"
Iu
Iu
Iu
Iu
Iu
Iu
Iu
Iu
Iu
Iu
Iu
sh
tp
sh
Iu
Iu
Iu
Iu
Iu
Iu
Iu
Iu
Iu
Iu
"}
(2,1,1) = {"
Iu
mJ
mJ
mJ
mJ
mJ
mJ
mJ
mJ
mJ
mJ
mJ
sh
mJ
mJ
mJ
mJ
mJ
mJ
mJ
mJ
mJ
mJ
Iu
"}
(3,1,1) = {"
Iu
mJ
mJ
mJ
mJ
Nf
Nf
Nf
Nf
mJ
sh
sh
sh
mJ
mJ
Nf
Nf
Nf
mJ
mJ
mJ
mJ
mJ
Iu
"}
(4,1,1) = {"
Iu
mJ
mJ
mJ
Nf
Nf
sh
sh
sh
sh
sh
mJ
sh
mJ
mJ
Nf
Nf
Nf
Nf
mJ
mJ
mJ
mJ
Iu
"}
(5,1,1) = {"
Iu
mJ
mJ
PN
mJ
sh
Ip
Ri
Ri
Ri
Ri
Ip
sh
oI
sh
PN
sh
ea
Nf
mJ
mJ
mJ
mJ
Iu
"}
(6,1,1) = {"
Iu
mJ
mJ
Nf
sh
sh
Hn
na
vx
SP
bI
mF
sh
sh
sh
mJ
sh
mJ
Nf
qX
mJ
mJ
mJ
Iu
"}
(7,1,1) = {"
Iu
mJ
mJ
ve
mJ
mJ
Hn
SP
SP
LG
SP
Jf
PN
mJ
PN
sh
sh
sh
PN
PN
Nf
mJ
mJ
Iu
"}
(8,1,1) = {"
Iu
mJ
mJ
Nf
PN
mJ
Hn
vx
bI
SP
SP
Jf
PN
PN
OG
PN
PN
Qu
sh
ea
PN
Nf
mJ
Iu
"}
(9,1,1) = {"
Iu
mJ
mJ
mJ
PN
mJ
Hn
SP
SP
Ax
SP
mF
PN
dI
oS
PN
mJ
sh
sh
mJ
PN
mJ
mJ
Iu
"}
(10,1,1) = {"
Iu
mJ
Nf
Nf
ea
PN
Ip
Pg
Pg
Pg
Pg
Ip
PN
OG
PN
PN
ea
sh
sh
sh
sh
sh
sh
Iu
"}
(11,1,1) = {"
sh
mJ
mJ
mJ
PN
PN
PN
mH
sh
sh
sh
mJ
mJ
pp
Nf
PN
sh
mH
sh
sh
sh
mJ
RT
sh
"}
(12,1,1) = {"
oe
sh
sh
sh
sh
sh
sh
sh
mJ
sh
sh
mJ
ow
PN
Nf
mJ
sh
mJ
sh
sh
sh
sh
sh
zi
"}
(13,1,1) = {"
sh
mJ
mJ
PN
PN
PN
mJ
sh
sh
sh
sh
mJ
PN
mJ
sh
PN
ea
sh
sh
mJ
sh
sh
sh
sh
"}
(14,1,1) = {"
Iu
mJ
mJ
ve
PN
Yn
PN
sh
PN
sh
sh
PN
PN
PN
mJ
PN
PN
Es
sh
sh
sh
sh
sh
Iu
"}
(15,1,1) = {"
Iu
mJ
mJ
mJ
PN
mJ
ea
sh
Ip
Ri
Jf
Ip
PN
PN
OG
PN
PN
mJ
sh
Ns
PN
mJ
sh
Iu
"}
(16,1,1) = {"
Iu
mJ
mJ
mJ
Nf
mJ
PN
mJ
Hn
vx
SP
mF
PN
oS
dI
mJ
PN
PN
PN
PN
ea
Nf
mJ
Iu
"}
(17,1,1) = {"
Iu
mJ
mJ
mJ
mJ
Nf
PN
PN
Hn
Ax
LG
mF
PN
ea
oS
PN
ea
mJ
mJ
PN
Nf
mJ
mJ
Iu
"}
(18,1,1) = {"
Iu
mJ
mJ
mJ
mJ
Nf
Nf
mJ
Ip
Pg
Pg
Ip
PN
PN
mJ
Nf
Nf
sh
mJ
PN
Nf
mJ
mJ
Iu
"}
(19,1,1) = {"
Iu
mJ
mJ
mJ
mJ
mJ
Nf
Nf
mJ
PN
sh
sh
sh
PN
Nf
mJ
mJ
PN
Ip
Jf
Ri
Ip
mJ
Iu
"}
(20,1,1) = {"
Iu
mJ
mJ
mJ
mJ
mJ
mJ
Nf
PN
ea
PN
mJ
sh
mJ
mJ
mJ
mJ
Nf
Hn
SP
Ax
mF
mJ
Iu
"}
(21,1,1) = {"
Iu
mJ
mJ
mJ
mJ
mJ
mJ
mJ
mJ
mJ
Nf
mJ
sh
mJ
mJ
mJ
mJ
mJ
Hn
bI
vx
mF
mJ
Iu
"}
(22,1,1) = {"
Iu
mJ
mJ
mJ
mJ
mJ
mJ
mJ
mJ
mJ
mJ
mJ
sh
mJ
mJ
mJ
mJ
mJ
Ip
Pg
Pg
Ip
mJ
Iu
"}
(23,1,1) = {"
Iu
mJ
mJ
mJ
mJ
mJ
mJ
mJ
mJ
mJ
mJ
mJ
sh
mJ
mJ
mJ
mJ
mJ
mJ
mJ
mJ
mJ
mJ
Iu
"}
(24,1,1) = {"
Iu
Iu
Iu
Iu
Iu
Iu
Iu
Iu
Iu
Iu
Iu
sh
JD
sh
Iu
Iu
Iu
Iu
Iu
Iu
Iu
Iu
Iu
Iu
"}

(1,1,2) = {"
Iu
Iu
Iu
Iu
Iu
Iu
Iu
Iu
Iu
Iu
Iu
sh
sh
PN
Iu
Iu
Iu
Iu
Iu
Iu
Iu
Iu
Iu
Iu
"}
(2,1,2) = {"
Iu
mJ
mJ
mJ
mJ
mJ
mJ
mJ
mJ
mJ
mJ
sh
sh
sh
mJ
mJ
mJ
mJ
mJ
mJ
mJ
mJ
mJ
Iu
"}
(3,1,2) = {"
Iu
mJ
mJ
mJ
mJ
mJ
mJ
mJ
mJ
mJ
mJ
sh
sh
sh
BQ
Nf
Nf
mJ
mJ
mJ
mJ
mJ
mJ
Iu
"}
(4,1,2) = {"
Iu
mJ
mJ
mJ
mJ
mJ
Nf
Nf
Nf
mJ
mJ
PN
mJ
sh
PN
PN
Nf
Nf
mJ
mJ
mJ
mJ
mJ
Iu
"}
(5,1,2) = {"
Iu
mJ
mJ
mJ
mJ
mJ
Nf
PN
PN
PN
PN
sh
PN
sh
PN
PN
Nf
mJ
mJ
mJ
mJ
mJ
mJ
Iu
"}
(6,1,2) = {"
Iu
mJ
mJ
mJ
mJ
qX
PN
PN
mJ
mJ
pp
sh
Qu
sh
mJ
Ip
Ri
Ri
Ri
Ip
mJ
mJ
mJ
Iu
"}
(7,1,2) = {"
Iu
mJ
mJ
mJ
mJ
sh
PN
sh
sh
sh
PN
PN
PN
sh
PN
Hn
sh
sh
gL
mF
Nf
mJ
mJ
Iu
"}
(8,1,2) = {"
Iu
mJ
mJ
mJ
mJ
sh
sh
Ip
Ri
Ri
Ip
PN
PN
gL
sh
JE
PN
mJ
sh
mF
Nf
Nf
mJ
Iu
"}
(9,1,2) = {"
Iu
mJ
mJ
mJ
mJ
Nf
PN
Hn
RG
PN
mF
PN
dI
PN
PN
Hn
PN
PN
rf
mF
Nf
Nf
mJ
Iu
"}
(10,1,2) = {"
Iu
mJ
mJ
mJ
mJ
Nf
PN
Hn
PN
PN
Cu
PN
PN
PN
PN
Ip
Pg
Pg
Pg
Ip
sh
sh
PN
Iu
"}
(11,1,2) = {"
PN
PN
mJ
mJ
mJ
Nf
PN
Ip
Pg
Pg
Ip
PN
PN
mJ
Nf
sh
sh
PN
PN
mJ
mJ
sh
sh
sh
"}
(12,1,2) = {"
sh
PN
PN
PN
mJ
Nf
PN
sh
sh
sh
sh
mJ
fn
PN
sh
PN
mJ
sh
PN
mJ
PN
sh
sh
sh
"}
(13,1,2) = {"
sh
sh
mJ
PN
PN
mJ
PN
sh
sh
sh
sh
mJ
mJ
sh
PN
Nf
mJ
sh
sh
sh
Es
sh
sh
PN
"}
(14,1,2) = {"
Iu
sh
Es
sh
sh
PN
PN
sh
mJ
sh
sh
mJ
oI
sh
sh
sh
sh
sh
sh
sh
mJ
PN
mJ
Iu
"}
(15,1,2) = {"
Iu
mJ
mJ
PN
sh
sh
sh
sh
Ns
PN
PN
PN
PN
PN
Ns
sh
mJ
PN
PN
sh
PN
Nf
mJ
Iu
"}
(16,1,2) = {"
Iu
mJ
mJ
mJ
PN
PN
sh
sh
sh
PN
mJ
PN
PN
PN
mJ
sh
PN
PN
PN
Nf
mJ
mJ
mJ
Iu
"}
(17,1,2) = {"
Iu
mJ
mJ
mJ
mJ
Nf
Nf
Nf
sh
sh
mH
PN
mJ
PN
sh
sh
PN
PN
Nf
mJ
mJ
mJ
mJ
Iu
"}
(18,1,2) = {"
Iu
mJ
mJ
mJ
mJ
mJ
mJ
Nf
Nf
sh
sh
sh
PN
PN
sh
sh
Yn
Nf
mJ
mJ
mJ
mJ
mJ
Iu
"}
(19,1,2) = {"
Iu
mJ
mJ
mJ
mJ
mJ
mJ
mJ
mJ
Nf
sh
sh
PN
mJ
sh
mJ
mJ
mJ
mJ
mJ
mJ
mJ
mJ
Iu
"}
(20,1,2) = {"
Iu
mJ
mJ
mJ
mJ
mJ
mJ
mJ
mJ
Nf
Nf
sh
PN
sh
sh
mJ
mJ
mJ
mJ
mJ
mJ
mJ
mJ
Iu
"}
(21,1,2) = {"
Iu
mJ
mJ
mJ
mJ
mJ
mJ
mJ
mJ
mJ
PN
sh
mJ
sh
PN
mJ
mJ
mJ
mJ
mJ
mJ
mJ
mJ
Iu
"}
(22,1,2) = {"
Iu
mJ
mJ
mJ
mJ
mJ
mJ
mJ
mJ
mJ
Es
sh
sh
sh
mJ
mJ
mJ
mJ
mJ
mJ
mJ
mJ
mJ
Iu
"}
(23,1,2) = {"
Iu
mJ
mJ
mJ
mJ
mJ
mJ
mJ
mJ
mJ
mJ
sh
sh
sh
mJ
mJ
mJ
mJ
mJ
mJ
mJ
mJ
mJ
Iu
"}
(24,1,2) = {"
Iu
Iu
Iu
Iu
Iu
Iu
Iu
Iu
Iu
Iu
Iu
PN
sh
sh
Iu
Iu
Iu
Iu
Iu
Iu
Iu
Iu
Iu
Iu
"}
