//MAP CONVERTED BY dmm2tgm.py THIS HEADER COMMENT PREVENTS RECONVERSION, DO NOT REMOVE
"a" = (
/turf/open/floor/rogue/dirt,
/area/rogue/outdoors/rtfield)
"d" = (
/obj/effect/spawner/lootdrop/general_loot_mid,
/obj/effect/spawner/lootdrop/general_loot_low,
/obj/structure/closet/crate/chest/wicker,
/turf/open/floor/rogue/twig,
/area/rogue/outdoors/rtfield)
"j" = (
/obj/structure/stairs{
	dir = 8
	},
/turf/open/transparent/openspace,
/area/rogue/outdoors/rtfield)
"l" = (
/obj/structure/stairs,
/turf/open/floor/rogue/twig,
/area/rogue/outdoors/rtfield)
"m" = (
/obj/effect/spawner/lootdrop/general_loot_mid,
/obj/effect/spawner/lootdrop/general_loot_mid,
/obj/structure/closet/crate/chest/wicker,
/turf/open/floor/rogue/twig,
/area/rogue/outdoors/rtfield)
"o" = (
/turf/open/floor/rogue/twig,
/area/rogue/outdoors/rtfield)
"q" = (
/obj/structure/roguetent,
/turf/open/floor/rogue/twig,
/area/rogue/outdoors/rtfield)
"t" = (
/obj/structure/bed/rogue/shit,
/turf/open/floor/rogue/twig,
/area/rogue/outdoors/rtfield)
"x" = (
/obj/structure/closet/crate/chest/wicker,
/obj/effect/spawner/lootdrop/general_loot_low,
/turf/open/floor/rogue/twig,
/area/rogue/outdoors/rtfield)
"y" = (
/obj/machinery/light/rogue/firebowl/stump,
/turf/open/floor/rogue/twig,
/area/rogue/outdoors/rtfield)
"B" = (
/mob/living/carbon/human/species/goblin/npc/sea,
/obj/structure/bed/rogue/shit,
/turf/open/floor/rogue/twig,
/area/rogue/outdoors/rtfield)
"C" = (
/obj/structure/closet/crate/chest/wicker,
/obj/effect/spawner/lootdrop/cheap_clutter_spawner,
/turf/open/floor/rogue/twig,
/area/rogue/outdoors/rtfield)
"D" = (
/obj/structure/roguetent,
/turf/open/floor/rogue/ruinedwood/turned,
/area/rogue/outdoors/rtfield)
"K" = (
/obj/effect/spawner/lootdrop/general_loot_mid,
/obj/structure/closet/crate/chest/wicker,
/turf/open/floor/rogue/twig,
/area/rogue/outdoors/rtfield)
"M" = (
/obj/structure/closet/crate/chest/wicker,
/obj/effect/spawner/lootdrop/general_loot_mid,
/turf/open/floor/rogue/twig,
/area/rogue/outdoors/rtfield)
"O" = (
/turf/closed/wall/mineral/rogue/wooddark,
/area/rogue/outdoors/rtfield)
"P" = (
/obj/structure/stairs{
	dir = 8
	},
/turf/open/floor/rogue/twig,
/area/rogue/outdoors/rtfield)
"R" = (
/turf/open/transparent/openspace,
/area/rogue/outdoors/rtfield)
"S" = (
/mob/living/carbon/human/species/goblin/npc/sea,
/turf/open/floor/rogue/twig,
/area/rogue/outdoors/rtfield)
"T" = (
/obj/structure/stairs,
/turf/open/transparent/openspace,
/area/rogue/outdoors/rtfield)
"W" = (
/turf/closed/wall/mineral/rogue/tent,
/area/rogue/outdoors/rtfield)

(1,1,1) = {"
a
a
a
a
a
a
a
a
a
a
a
a
a
"}
(2,1,1) = {"
a
a
a
O
W
W
D
W
W
W
W
O
a
"}
(3,1,1) = {"
O
W
W
O
M
o
o
o
o
o
o
W
a
"}
(4,1,1) = {"
W
o
d
o
o
o
o
o
x
S
o
W
a
"}
(5,1,1) = {"
W
o
o
o
o
S
o
o
o
o
o
W
a
"}
(6,1,1) = {"
W
o
o
o
o
o
o
o
o
o
o
O
a
"}
(7,1,1) = {"
D
o
o
o
o
y
o
o
o
o
o
D
a
"}
(8,1,1) = {"
W
o
o
o
o
o
o
o
O
O
O
O
a
"}
(9,1,1) = {"
W
o
o
S
o
o
o
o
O
O
O
a
a
"}
(10,1,1) = {"
W
K
o
o
o
o
o
o
P
P
W
a
a
"}
(11,1,1) = {"
O
W
W
W
O
C
o
o
o
o
W
a
a
"}
(12,1,1) = {"
a
a
a
a
O
D
W
W
W
W
O
a
a
"}

(1,1,2) = {"
R
R
R
R
R
R
R
R
R
R
R
R
R
"}
(2,1,2) = {"
R
R
R
o
o
o
o
o
o
o
o
o
R
"}
(3,1,2) = {"
o
o
o
O
W
W
W
W
W
W
O
o
R
"}
(4,1,2) = {"
o
S
o
W
t
t
t
t
B
t
W
o
R
"}
(5,1,2) = {"
o
o
o
W
o
o
o
o
o
o
W
o
R
"}
(6,1,2) = {"
o
o
o
q
o
o
o
o
o
o
W
o
R
"}
(7,1,2) = {"
o
o
o
W
t
B
t
t
o
o
W
o
R
"}
(8,1,2) = {"
o
o
o
O
W
W
W
O
o
o
O
o
R
"}
(9,1,2) = {"
o
o
o
o
o
l
O
W
j
j
W
R
R
"}
(10,1,2) = {"
o
S
o
o
o
l
O
W
R
R
W
R
R
"}
(11,1,2) = {"
o
o
o
o
o
o
o
O
W
W
O
R
R
"}
(12,1,2) = {"
R
R
R
R
o
o
o
o
o
o
o
R
R
"}

(1,1,3) = {"
R
R
R
R
R
R
R
R
R
R
R
R
R
"}
(2,1,3) = {"
R
R
R
R
R
R
R
R
R
R
R
R
R
"}
(3,1,3) = {"
R
R
R
o
o
o
o
o
o
o
o
R
R
"}
(4,1,3) = {"
R
R
R
o
o
o
o
o
o
o
o
R
R
"}
(5,1,3) = {"
R
R
R
o
o
S
o
m
o
S
o
R
R
"}
(6,1,3) = {"
R
R
R
o
o
o
o
o
o
o
o
R
R
"}
(7,1,3) = {"
R
R
R
o
o
o
o
o
o
o
o
R
R
"}
(8,1,3) = {"
R
R
R
o
o
o
o
o
o
o
o
R
R
"}
(9,1,3) = {"
R
R
R
R
R
R
T
o
o
o
o
R
R
"}
(10,1,3) = {"
R
R
R
R
R
R
T
o
o
o
o
R
R
"}
(11,1,3) = {"
R
R
R
R
R
R
R
o
o
o
o
R
R
"}
(12,1,3) = {"
R
R
R
R
R
R
R
R
R
R
R
R
R
"}
