//MAP CONVERTED BY dmm2tgm.py THIS HEADER COMMENT PREVENTS RECONVERSION, DO NOT REMOVE
"a" = (
/turf/open/floor/rogue/dirt,
/area/rogue/outdoors/rtfield)
"b" = (
/turf/open/floor/rogue/twig,
/area/rogue/outdoors/rtfield)
"c" = (
/obj/structure/rack/rogue,
/obj/effect/spawner/lootdrop/roguetown/dungeon/tools,
/turf/open/floor/rogue/twig,
/area/rogue/outdoors/rtfield)
"e" = (
/mob/living/carbon/human/species/akula/npc,
/turf/open/floor/rogue/twig,
/area/rogue/outdoors/rtfield)
"g" = (
/turf/open/transparent/openspace,
/area/rogue/outdoors/rtfield)
"l" = (
/obj/structure/rack/rogue,
/obj/effect/spawner/lootdrop/roguetown/dungeon/armor,
/turf/open/floor/rogue/twig,
/area/rogue/outdoors/rtfield)
"m" = (
/obj/effect/landmark/chest_or_mimic/locked_or_trapped,
/turf/open/floor/rogue/twig,
/area/rogue/outdoors/rtfield)
"B" = (
/obj/structure/closet/crate/chest,
/obj/effect/spawner/lootdrop/magic_loot_tier_2/x3,
/obj/effect/spawner/lootdrop/magic_loot_tier_1,
/turf/open/floor/rogue/twig,
/area/rogue/outdoors/rtfield)
"E" = (
/mob/living/carbon/human/species/akula/npc,
/turf/open/floor/rogue/dirt,
/area/rogue/outdoors/rtfield)
"O" = (
/obj/structure/rack/rogue,
/turf/open/floor/rogue/twig,
/area/rogue/outdoors/rtfield)
"P" = (
/obj/structure/rack/rogue,
/obj/effect/spawner/lootdrop/roguetown/dungeon/weapons,
/turf/open/floor/rogue/twig,
/area/rogue/outdoors/rtfield)
"S" = (
/turf/closed/wall/mineral/rogue/wooddark,
/area/rogue/outdoors/rtfield)
"W" = (
/obj/structure/bed/rogue/shit,
/turf/open/floor/rogue/twig,
/area/rogue/outdoors/rtfield)

(1,1,1) = {"
a
a
a
a
a
a
a
a
a
a
a
a
a
"}
(2,1,1) = {"
a
S
S
a
a
a
a
a
a
a
S
S
a
"}
(3,1,1) = {"
a
S
S
a
a
a
a
a
E
a
S
S
a
"}
(4,1,1) = {"
a
a
a
a
a
a
a
a
a
a
a
a
a
"}
(5,1,1) = {"
a
E
a
a
a
S
S
S
a
a
a
a
a
"}
(6,1,1) = {"
a
a
S
S
a
a
a
a
a
S
S
a
a
"}
(7,1,1) = {"
a
a
S
S
a
a
a
a
a
S
S
a
a
"}
(8,1,1) = {"
a
a
a
a
a
S
S
S
a
a
a
E
a
"}
(9,1,1) = {"
a
a
a
a
a
a
a
a
a
a
a
a
a
"}
(10,1,1) = {"
a
S
S
a
a
a
a
a
a
a
S
S
a
"}
(11,1,1) = {"
a
S
S
a
E
a
a
a
a
a
S
S
a
"}
(12,1,1) = {"
a
a
a
a
a
a
a
a
a
a
a
a
a
"}

(1,1,2) = {"
g
g
g
g
g
g
g
g
g
g
g
g
g
"}
(2,1,2) = {"
g
b
b
b
b
b
b
b
b
b
b
b
g
"}
(3,1,2) = {"
g
S
S
b
b
b
e
b
b
b
S
S
g
"}
(4,1,2) = {"
g
g
g
l
c
b
b
b
P
P
g
g
g
"}
(5,1,2) = {"
g
g
g
g
g
b
b
b
g
g
g
g
g
"}
(6,1,2) = {"
g
g
S
S
g
g
g
g
g
S
S
g
g
"}
(7,1,2) = {"
g
g
S
S
g
g
g
g
g
S
S
g
g
"}
(8,1,2) = {"
g
g
g
g
g
b
b
b
g
g
g
g
g
"}
(9,1,2) = {"
g
g
g
P
P
b
b
b
O
l
g
g
g
"}
(10,1,2) = {"
g
S
S
b
b
b
e
b
b
b
S
S
g
"}
(11,1,2) = {"
g
b
b
b
b
b
b
b
b
b
b
b
g
"}
(12,1,2) = {"
g
g
g
g
g
g
g
g
g
g
g
g
g
"}

(1,1,3) = {"
g
g
g
g
g
g
g
g
g
g
g
g
g
"}
(2,1,3) = {"
g
g
g
g
g
g
g
g
g
g
g
g
g
"}
(3,1,3) = {"
g
b
b
g
g
g
g
g
g
g
b
b
g
"}
(4,1,3) = {"
g
b
b
g
g
g
g
g
g
g
b
b
g
"}
(5,1,3) = {"
g
b
b
g
W
W
B
W
W
g
b
b
g
"}
(6,1,3) = {"
g
b
e
b
b
b
b
b
b
b
e
b
g
"}
(7,1,3) = {"
g
b
b
b
b
b
b
b
b
b
b
b
g
"}
(8,1,3) = {"
g
b
b
g
W
W
m
W
W
g
b
b
g
"}
(9,1,3) = {"
g
b
b
g
g
g
g
g
g
g
b
b
g
"}
(10,1,3) = {"
g
b
b
g
g
g
g
g
g
g
b
b
g
"}
(11,1,3) = {"
g
g
g
g
g
g
g
g
g
g
g
g
g
"}
(12,1,3) = {"
g
g
g
g
g
g
g
g
g
g
g
g
g
"}
